111111111111111111111
10010000001000F001111
11100000PC001000G0001
1CCC0E011000100011001
111111111111111111111